1111111111111
1C010000000C1
100C001111001
1P0011E000001
1111111111111