1111111111111
1100000000C11
110C001100111
1P0011E000001
111111111P111